10,20
++++++++++++++++++++
+                  +
+++ + ++++ + +++++ +
+ + +++ ++ + ++ ++ +
+ +   +    + ++    +
+ +++ ++++++ +++++++
+   +     ++ + +   +
+ +++s+++ ++ + +g+ +
+ +       ++ +   + +
++++ +++++++++++++++
